################
#            O #
#     P     ####
#              #
########       #
#   O  #       #
#      #       #
#      #       #
#           XX #
#           #  #
################